AAAAAAAAAAAAAAA
AAAAAAAAAAAAAAA
AAAAAAAAAAAAAAA
AAAAATAATTAAAAA
AAAAATAAAAAAAAA
AAAAATAMATAAAAA
AAGGCAAAAAAAAAA
AATTTTTAAATTTTA
AAAAAAAAAAAAAFA
AAAAAAAAAAAAAAA
AAAAAAAAAAAAAAA
AAAAAAAAAAAAAAA
AAAAAAAAAAAAAAA
AAAAAAAAAAAAAAA
AAAAAAAAAAAAAAA