AAAAAAAAAAAAAAA
AAAAAAAAAAAAAAA
AAAAAAAAAAAAAAA
AAAAATAATTAAAAA
AAAAATAAAAAAAAA
AAAAATAMATAAAAA
AAGGCMMAAAAAAAA
AATTTTTAAATTTTA
AAAAAAMMMMMAAFA
AAAAAAAAAAAAAAA
AAAAAAAAAAAAAAA
AAAAAAAAAAAAAAA
AAAAAAAAAAAAAAA
AAAAAAAAAAAAAAA
AAAAAAAAAAAAAAA